Example text file

15 15
###############
#             #
#   ###       #
#   #  G      #
#   #         #
#             #
#             #
#  ############
#          ####
#    ###      #
#     #       #
#      #      #
#       #     #
#           S #
###############
